# http://www.imena.org/decl_fn.html
жа - жа жи же жу жой же
ша - ша ши ше шу шой ше
ча - ча чи че чу чой че
ща - ща щи ще щу щой ще
ца - ца ци це цу цой це
га - га ги ге гу гой ге
ка - ка ки ке ку кой ке
ха - ха хи хе ху хой хе
а - а ы е у ой е
б - б бы бе бу бой бе
в - в вы ве ву вой ве
г - г гы ге гу гой ге
ж - ж жи же жу жой же
з - з зы зе зу зой зе
й - й и е ю ей е
к - к кы ке ку кой ке
л - л лы ле лу лой ле
м - м мы ме му мой ме
н - н ны не ну ной не
п - п пы пе пу пой пе
р - р ры ре ру рой ре
с - с сы се су сой се
т - т ты те ту той те
ф - ф фы фе фу фой фе
х - х хы хе ху хой хе
ч - ч чи че чу чей че
ь - ь и и ь ью и
ия - ия ии ии ию ией ии
я - я и е ю ей е