# http://www.imena.org/decl_mn.html
пётр - пётр петра петру петра петром петре
лев - лев льва льву льва львом льве
павел - павел павла павлу павла павлом павле
гаврило - гаврило гаврилы гавриле гаврилу гаврилой гавриле
данило - данило данилы даниле данилу данилой даниле
измайло - измайло измайлы измайле измайлу измайлой измайле
мануйло - мануйло мануйлы мануйле мануйлу мануйлой мануйле
михайло - михайло михайлы михайле михайлу михайлой михайле
жа - жа жи же жу жой же
ша - ша ши ше шу шой ше
ща - ща щи ще щу щой ще
ча - ча чи че чу чой че
га - га ги ге гу гой ге
ка - ка ки ке ку кой ке
ха - ха хи хе ху хой хе
ца - ца ци це цу цой це
а - а ы е у ой е
б - б ба бу ба бом бе
в - в ва ву ва вом ве
г - г га гу га гом ге
ж - ж жа жу жа жем же
з - з за зу за зом зе
# и - 
ий - ий ия ию ия ием ии
й - й я ю я ем е
к - к ка ку ка ком ке
л - л ла лу ла лом ле
м - м ма му ма мом ме
н - н на ну на ном не
п - п па пу па пом пе
р - р ра ру ра ром ре
с - с са су са сом се
т - т та ту та том те
# у - 
ф - ф фа фу фа фом фе
х - х ха ху ха хом хе
ц - ц ца цу ца цем це
ч - ч ча чу ча чем че
ш - ш ша шу ша шем ше
щ - щ ща щу ща щем ще
# ы - 
ь - ь я ю я ем е
# э - 
# ю - 
я - я и е ю ёй е