вич - вич вича вичу вича вичем виче
#
ов - ов ова ову ова овым ове
ев - ев ева еву ева евым еве
ин - ин ина ину ина иным ине
ын - ын ына ыну ына ыным ыне
ский - ский ского скому ского ским ском
цкий - цкий цкого цкому цкого цким цком
# Отдельно случаи окончаний ых и их - не склоняются
ых - ых ых ых ых ых ых
их - их их их их их их
б - б ба бу ба бом бе
в - в ва ву ва вом ве
г - г га гу га гом ге
д - д да ду да дом де
ж - ж жа жу жа жом же
з - з за зу за зом зе
й - й я ю я ем е
к - к ка ку ка ком ке
л - л ла лу ла лом ле
м - м ма му ма мом ме
н - н на ну на ном не
п - п па пу па пом пе
р - р ра ру ра ром ре
с - с са су са сом се
т - т та ту та том те
ф - ф фа фу фа фом фе
х - х ха ху ха хом хе
ц - ц ца цу ца цом це
ч - ч ча чу ча чом че
ш - ш ша шу ша шом ше
щ - щ ща щу ща щом ще
ь - ь я ю я ем е
# Отдельно случай гласной перед а - не склоняется
аа - аа аа аа аа аа аа
еа - еа еа еа еа еа еа
ёа - ёа ёа ёа ёа ёа ёа
иа - иа иа иа иа иа иа
оа - оа оа оа оа оа оа
уа - уа уа уа уа уа уа
эа - эа эа эа эа эа эа
юа - юа юа юа юа юа юа
яа - яа яа яа яа яа яа
# 
га - га ги ге гу гой ге
ка - ка ки ке ку кой ке
ха - ха хи хе ху хой хе
ча - ча чи че чу чой че
ща - ща щи ще щу щой ще
жа - жа жи же жу жой же
а - а ы е у ой е
я - я и е ю ёй еs